4 2 1 4 2 2 4
2 2 4 4 1 1 3
1 1 3 1 1 1 2
1 4 3 3 1 4 3
1 1 2 1 4 2 1
